0 0 0 0 0 0 0 0 0 0
0 0 0 0 7 0 0 0 0 0
7 0 6.1 0 7 0 5.2 0 0 0
0 0 0 0 0 0 0 0 0 0
0 0 0 0 0 0 0 0 0 0
7 0 7 7 7 0 0 5.3 0 0
7 0 0 0 7 0 0 0 0 0
7 0 1 0 7 0 0 0 0 0